......................................................................................................................................................................
......................................................................................................................................................................
......................................................................................................................................................................
......................................................................................................................................................................
......................................................................................................................................................................
......................................................................................................................................................................
....................................................................................................................................|.................................
.......................................................................................................................X............|.................................
......................................................................................................................XX............|.................................
...........*.........................................................................................................XXX............|.................................
....................................................................................................................XXXX............|.................................
.........CCMMC....B%...................................VV...............................^^.........................XXXXX............|.................................
...............................X..X.........%1%........pp.....PP........................pp........................XXXXXX............|.................................
..............................XX..XX...................pp.....pp........................pp.......................XXXXXXX............|.................................
GGGGGGGGGGGGGGGGGGGGGGGGGGGGGGGG..GGGGGGGGGGGGGGGGGGGGGGGGGGGGGGGGGGGGGGGGG...GGGGGGGGGGGGGGGGGGGGGGGGGGGGGGGGGGGGGGGGGGGGGGGGGGGGGGGGGGGGGGGGGGGGGGGGGGGGGGGGGGGGGGGG
GGGGGGGGGGGGGGGGGGGGGGGGGGGGGGGG..GGGGGGGGGGGGGGGGGGGGGGGGGGGGGGGGGGGGGGGGG...GGGGGGGGGGGGGGGGGGGGGGGGGGGGGGGGGGGGGGGGGGGGGGGGGGGGGGGGGGGGGGGGGGGGGGGGGGGGGGGGGGGGGGGG